   ....................................................................................................................................................
   .     .     .        .  .     .                             .           .        .        .  .     .        .  .                 .  .  .  .        .
.  .  ....  .  .  .......  ....  ....  ....  .  .........................  ....  ....  .  ....  .  .  .  .  .  .  .  .  .......  .  .  .  .  .  .......
.     .     .  .                 .     .     .  .                 .     .           .  .        .  .  .  .  .        .  .     .  .  .     .        .  .
.  .......  .  .  .  .......  ....  .......  ....  .......  .......  ..........  .  .  ..........  ..........  ....  .  .  .  ..........  .  .......  .
.     .     .  .  .     .           .     .     .     .                    .     .  .     .        .  .        .  .  .     .  .  .     .              .
.  ..........  .  ..........  .  ....  .  .  ................  .  ....  .  .......  ....  .  ....  .  ....  .  .  .......  ....  ....  .  ....  .  .  .
.  .     .        .        .  .     .  .     .  .     .  .  .  .  .     .        .     .  .  .  .     .  .  .  .  .  .                       .  .  .  .
.  ....  .  .......  .  ....  ....  .......  .  .  ....  .  ....  ....  ....  .  ....  .  .  .  ....  .  .  .  .  .  ....  .  ....  ....  ..........  .
.  .        .     .  .  .  .     .     .     .        .        .  .        .  .     .           .     .     .        .  .  .     .  .     .        .  .
.  .  ....  ....  ....  .  .......  ....  .......  .......  .......  .  ....  .......  .  ....  .  .......  .......  .  ....  ....  ....  .......  ....
.  .  .  .     .                 .  .  .  .              .  .  .  .  .     .           .     .  .     .     .           .     .     .  .           .  .
.  .  .  ..........  ....  .  ....  .  ..........  .......  .  .  ....  ................  ....  ...............................  .  .  .  .......  .  .
.  .           .        .  .  .     .           .           .     .     .     .     .  .  .  .                 .           .     .  .        .     .  .
.  ..........  .  .......  ..........  ....  ....  ....  .......  .  .......  .  ....  .  .  .  .........................  .......  ....  ..........  .
.     .     .     .  .  .  .     .     .  .        .     .     .     .  .     .  .     .  .  .        .  .           .  .           .              .  .
.  ....  .......  .  .  .  ....  .......  ....  .............  ....  .  .  .  .  .  ....  .  ....  .  .  ....  .......  .  ....  ..........  .......  .
.           .  .        .  .              .     .  .           .  .  .     .        .     .  .     .  .  .  .           .     .        .  .           .
.  ..........  .  ....  .  ....  ..........  ....  ....  .  ....  ....  ....  .  .  .  .  .  ..........  .  .  ....  .......  ..........  ..........  .
.  .        .     .  .  .  .              .  .  .  .     .     .  .        .  .  .     .     .     .        .     .              .  .           .  .  .
.  .  ..........  .  .  ....  ....  ....  .  .  .  .  .......  .  .  ....  .  .  .  .  .  ....  ....  .  ....  ..........  .......  ....  .......  ....
.        .  .     .           .     .  .        .  .  .  .     .  .  .  .  .  .  .  .  .  .  .        .  .  .  .        .           .     .  .  .     .
....  ....  .  ....  ................  .......  .  .  .  .  ....  .  .  .......  ....  ....  ....  .......  .  .  ....  .  ....  .......  .  .  ....  .
.  .     .  .     .     .  .     .  .  .              .           .  .     .        .        .     .                 .  .     .  .  .  .  .           .
.  .  ....  .  .......  .  .  ....  .  ....  .............  ....  .  .  ....  .  ..........  ....  .......  .  ................  .  .  .  ....  ....  .
.     .  .  .  .              .  .     .           .     .  .  .     .        .        .     .           .  .     .  .        .  .     .  .  .  .     .
.  .  .  .  ....  .  .......  .  ....  .......  .  ....  .  .  .......  ..........  ....  .  ....  .  ....  .  ....  .  .  ....  .  ....  .  .  ....  .
.  .              .  .  .  .     .     .     .  .     .     .              .     .     .  .  .  .  .     .  .           .  .                    .     .
.  .  ....  ....  .  .  .  .......  ....  ....  .  .......  .......  .......  .............  .  .......  .......  .............  ..........  .  .......
.  .  .  .  .  .  .        .  .     .     .     .  .  .  .        .  .                 .           .     .  .  .     .  .     .  .        .  .        .
.  ....  .  .  .  ....  ....  ....  ....  ....  ....  .  .  ....  .  .  .......  .  ....  ....  .......  .  .  ....  .  .  .  ....  .  ................
.     .  .     .     .  .     .              .     .        .     .  .  .  .     .  .     .     .  .  .           .     .  .     .  .           .     .
.  ....  ....  ....  .......  .......  ....  ....  ....  .  ..........  .  .......  .  ....  .  .  .  ....  .  ....  .  .  ..........  ....  ....  .  .
.        .     .     .  .     .        .     .     .     .     .  .     .                 .  .  .     .     .  .     .        .  .     .  .  .     .  .
.  ....  .  .  ....  .  ....  .............  .  .  ....  .  ....  ..........  .  .......  .  .......  ....  ....  ....  .  .  .  .  ....  ..........  .
.     .  .  .     .     .     .              .  .     .  .     .  .     .  .  .  .     .  .        .  .           .     .  .  .  .     .     .        .
....  ....  .......  .......  .  ....  ..........  .  .......  .  .  ....  .  ....  ....  .......  .  .......  ....  .  ....  .  .  .......  .  ....  .
.  .     .     .  .     .           .     .     .  .        .  .     .              .     .     .           .  .     .  .  .           .  .     .     .
.  .............  .......  ....  .......  ....  .  ....  ....  .  .  .  ..........  .  .......  .  .......  ....  ....  .  .  ....  .  .  .  ..........
.     .     .     .     .  .        .  .           .     .     .  .           .     .     .  .  .  .     .  .  .     .  .  .     .  .     .           .
.  .  ....  ....  ....  .  .......  .  .......  ............................  .  ..........  .  ....  .  .  .  ....  ....  .  .  ....  ....  .......  .
.  .     .           .           .           .  .        .     .  .           .  .  .                 .  .  .  .           .  .  .              .  .  .
.  ....  .  ....  .............  ................  .......  .  .  .......  .  .  .  .  ....  .......  .  .  .  ....  ....  .......  ..........  .  ....
.     .  .  .     .        .           .           .  .  .  .        .  .  .  .           .  .        .  .     .     .  .  .  .     .                 .
.  ....  ....  .......  .......  ................  .  .  .  .  .  .  .  ....  .  ................  .............  ....  .  .  ..........  .  .  .  ....
.  .              .  .                 .  .           .  .  .  .  .           .        .     .     .  .     .     .     .        .        .  .  .     .
....  .  ....  ....  .......  ....  .  .  .  .  ....  .  ....  ....  ......................  .  ....  ....  .  ....  ............................  ....
.     .  .     .     .        .     .  .     .  .           .  .  .  .     .           .  .        .     .  .  .  .     .           .  .     .     .  .
.  ....  ....  .  ....  .  .  ....  ....  ....  .  .......  .  .  ....  ....  .  ....  .  .  .  ....  .  .  .  .  .  ..........  ....  .  .  ....  .  .
.  .     .  .  .        .  .     .     .  .  .  .     .                    .  .  .        .  .  .  .  .  .     .     .     .  .        .  .           .
.  .......  .  .  ................  .  ....  ....  .......  ....  ....  ....  .  .  .  ..........  ....  ....  .  .  .  ....  ....  ...................
.        .                 .     .  .  .     .  .  .  .  .     .  .     .  .  .  .  .        .              .     .  .        .        .     .  .     .
.  .......  .  .......  ....  ....  .......  .  .  .  .  .  ....  .......  .......  ....  .............  .  .  ..........  ..........  .  ....  .  ....
.  .        .  .  .        .     .  .     .        .        .           .     .     .  .  .        .     .  .                 .              .     .  .
....  ..........  .......  .  ....  ....  ..........  .  .  ................  .  ....  .......  ....  .......  .......  ....  .............  ....  .  .
.  .  .        .        .     .     .     .  .  .  .  .  .  .  .     .  .     .        .  .  .        .  .        .        .              .  .     .  .
.  .  .  .......  ....  .......  .  .  ....  .  .  .  ....  .  .  ....  ....  ....  .  .  .  .  .  .  .  .  .............  .......  ....  .  .  .  .  .
.  .           .  .     .  .  .  .  .                    .     .        .  .  .     .     .     .  .     .  .              .     .     .     .  .     .
.  ....  ..........  .  .  .  .  .  .......  ..........  ..........  ....  .  ....  .  ....  ..........  .  ....  .  ....  .  ....  ..........  .......
.                 .  .        .  .     .  .     .              .  .  .     .        .        .     .  .  .     .  .  .  .  .        .                 .
..........  ....  .......  ....  .......  .  .  ....  .  .......  .  .  ....  .............  .  .  .  .  .......  ....  .  ....  ....  .  ....  .  .  .
.        .  .  .  .  .     .     .  .     .  .     .  .     .              .        .           .     .        .  .     .  .        .  .  .  .  .  .  .
.......  ....  .  .  ....  .  ....  ....  ....  .......  .  .  ....  ....  ....  .............  .  .  .  .......  ....  .  .......  ....  .  ....  ....
.  .     .     .     .     .  .     .        .  .     .  .     .        .  .     .        .     .  .  .              .  .        .        .  .  .     .
.  ....  .  .  ....  ....  .......  .  ....  .......  .  .  ....  .......  .......  .  .......  .  .  ..........  ....  ....  ....  .  ....  .  .  .  .
.           .  .  .  .  .  .        .  .     .  .        .     .     .           .  .  .     .  .  .     .     .  .     .        .  .     .        .  .
.......  ....  .  .  .  .  ....  .  .  .......  ....  .  .  ..........  ....  .  .  .  .  .  ....  ....  .  .  ....  .......  .  .  .  .......  ....  .
.  .  .     .  .        .     .  .                 .  .  .        .     .     .     .  .  .           .     .        .  .     .  .  .  .        .     .
.  .  .......  .  .......  ....  .  ................  ......................  .......  .......  .  .  .......  .  .  .  .  ....  .  ....  ..........  .
.        .     .           .  .  .  .           .     .        .  .     .  .     .  .           .  .     .     .  .     .     .  .     .  .     .  .  .
.  .......  .  ....  .  ....  ....  ....  .......  .  ....  ....  .  ....  ....  .  ....  .  .  .......  ............................  ....  .  .  ....
.     .  .  .        .     .     .  .        .  .  .        .        .     .  .     .  .  .  .        .  .  .  .     .        .        .     .        .
....  .  .  ..........  .  ....  .  .  ....  .  ....  ....  ....  .  ....  .  .  .  .  .  .......  .......  .  .  .......  .  ....  .  .  .  .......  .
.        .           .  .              .  .        .  .           .           .  .  .        .     .                 .  .  .     .  .     .        .  .
.  .  ....  .  .......  ....  .......  .  .  ..........  ........................................  ....  .  .  ....  .  .......  .  .......  ....  .  .
.  .  .  .  .     .  .  .  .     .  .     .        .        .           .     .     .        .           .  .  .  .     .        .     .     .  .  .  .
.  ....  ....  ....  .  .  .  ....  .......  ....  .  ....  ....  .......  .  ....  .......  ....  ....  .  ....  .............  .......  ....  .  .  .
.                    .     .  .        .     .  .  .  .     .        .     .              .           .  .     .                 .  .  .        .  .  .
....  .  ....  ....  .......  ....  ....  ....  .......  ....  ....  ....  .  .  .......  .  ..........  .......  .  .......  .  .  .  .  .  ....  ....
.  .  .  .     .        .  .  .        .        .  .  .  .     .     .     .  .        .              .        .  .  .     .  .           .  .  .  .  .
.  .  .  ................  ....  ..........  ....  .  .......  .  ..........  .  .  .  ....  .......  .  .......  ....  .  ...................  .  .  .
.     .     .     .           .        .        .  .  .  .  .  .  .        .  .  .  .  .     .  .     .  .  .           .  .  .  .  .     .        .  .
.  ....  .  .  ....  ....  .......  ....  ....  .  .  .  .  .  ....  .  .  .  ................  .  .  ....  .......  .  ....  .  .  .  ....  .  ....  .
.  .  .  .        .     .     .  .     .     .     .  .  .     .  .  .  .        .        .     .  .  .  .           .     .     .     .  .  .        .
.  .  .......  .  .  .......  .  .  .............  .  .  .  ....  ................  .  ....  .  .  .  .  .  .......  .  ....  .......  .  ....  .......
.        .     .     .     .  .     .        .              .        .              .        .     .  .        .  .  .        .           .           .
....  ..........  .  .  ..........  .  .  ....  ...................  .  .  .............  ....  ..........  .  .  ....  .......  .......  ....  .......
.  .  .     .     .                    .  .              .           .  .  .           .  .           .     .        .  .  .  .  .  .  .  .     .     .
.  ....  .  .......  .  ................  ....  .  ................  .  .  ..........  .  ......................  .......  .  .  .  .  .......  .  ....
.        .           .        .              .  .  .     .        .  .  .     .           .     .  .                 .  .     .     .                 .
.  ....  ....  ....  .  .  .  ..........  .......  .  .......  ....  .......  .  .......  ....  .  .  .  .  ....  ....  ....  ....  ....  ....  .  ....
.     .  .     .     .  .  .     .     .     .        .  .  .        .  .     .        .  .     .     .  .     .     .  .  .           .  .     .  .  .
.  .......  .......  .......  .......  ....  ..........  .  ....  ....  .............  .  ....  ....  .............  .  .  .  ....  ....  ..........  .
.  .  .  .        .     .     .  .        .              .           .           .     .  .           .        .  .        .  .              .     .  .
.  .  .  .  ....  ....  .  .  .  .......  .  .............  .  ....  ..........  .  ....  .  .  .......  .  ....  ....  .............  .......  ....  .
.  .     .  .        .  .  .  .           .  .  .     .  .  .  .     .        .     .     .  .     .     .  .              .           .  .     .     .
.  ....  .  ..........  .......  .......  ....  .  ....  .  ..........  .......  .............  .  .  ..........  ................  ....  ....  ....  .
.  .     .  .  .  .           .  .  .  .     .  .        .     .                       .        .     .  .              .  .  .        .              .
.  .  .......  .  ....  .  .  .  .  .  ....  .  ....  .  ....  ....  .  .......  ..........  .  .  ....  .  ....  .......  .  .......  .  ..........  .
.     .                 .  .              .           .           .  .     .           .     .  .     .        .        .                       .     
....................................................................................................................................................  
