   .............
      .  .     .
....  .  .  .  .
.        .  .  .
.  ....  .  ....
.  .     .     .
....  .  .  .  .
.  .  .     .  .
.  ....  ....  .
.        .     
.............  
