   ..........................................................
   .        .              .                 .  .  .  .  .  .
.  .  ..........  .......  .  ....  ..........  .  .  .  .  .
.     .     .        .     .  .              .        .     .
....  .  .  .  .......  ....  .......  ....  .  ....  ....  .
.        .           .     .     .  .  .     .  .           .
.  .............  ....  ....  ....  ..........  .  ....  .  .
.  .     .     .     .        .  .  .  .        .     .  .  .
.  ....  ....  ....  .......  .  .  .  .  .  .  .............
.  .  .        .     .  .           .  .  .  .  .        .  .
.  .  .......  .......  .  .  .......  .  .  ....  ....  .  .
.  .  .        .           .  .     .  .  .     .     .  .  .
....  .  ....  .  ....  .......  ....  ....  ....  .  ....  .
.     .     .     .  .        .  .        .     .  .        .
....  .  ....  .  .  ....  ....  .......  .  ....  ..........
.  .     .     .        .  .     .  .           .  .  .     .
.  .  .  ....  .............  .  .  ....  .......  .  .  ....
.     .     .           .     .  .                 .        .
....  ....  .  ................  ..........  ....  .......  .
.  .  .  .  .  .     .        .     .     .  .  .  .  .     .
.  ....  ....  .  ..........  ....  .  ....  .  ....  .  ....
.           .  .        .     .  .        .        .  .     .
.  ....  .  .  ....  .  .  ....  ....  ..........  .  .  .  .
.  .     .     .     .           .           .           .  .
.  ....  .  .  .  ..........  .......  ....  .......  .......
.  .     .  .        .     .        .     .  .              .
................  .  .  ....  ....  ....  ....  .  .......  .
.  .     .     .  .  .           .     .        .  .        .
.  ....  .  .  ....  .......  ....  .  ....  ................
.  .  .     .     .        .  .     .           .  .        .
.  .  .  .  .  .  .  .............  ....  .  ....  .  ....  .
.     .  .  .  .     .  .        .  .     .  .  .        .  .
.  .  ..........  ....  .  .  ....  ....  ....  .  .......  .
.  .              .     .  .        .        .        .     .
.......  ....  ....  ....  .......  ..........  .  ..........
.  .     .  .     .     .     .  .              .     .     .
.  ....  .  .  .  ....  .......  ....  .......  .......  .  .
.     .  .     .     .  .                 .     .        .  .
.  ....  .......  ....  .  .  .  .......  ....  .  .  ....  .
.              .  .        .  .     .     .        .  .     
..........................................................  
