   ............................
               .              .
.  ...................  ....  .
.              .        .     .
.  .......  ....  .  ..........
.  .     .     .  .  .        .
.  .  ..........  ....  .  ....
.  .  .  .        .     .  .  .
.  .  .  .......  ....  ....  .
.     .  .     .  .        .  .
....  .  .  ....  .  .  ....  .
.     .           .  .  .  .  .
....  .  .  .  .  ....  .  .  .
.     .  .  .  .        .     .
....  .......  .......  .  .  .
.              .           .  .
..........  .  .  ....  ....  .
.           .  .     .     .  .
.  ....  ....  ....  .......  .
.     .     .     .        .  
............................  
