   ........................................................................................
   .     .                 .        .                       .  .     .  .     .  .        .
.  .  .  ..........  ....  ....  .  .......  ....  ....  ....  .  .  .  .  ....  ....  .  .
.  .  .     .     .     .  .  .  .  .     .  .     .        .  .  .  .  .        .  .  .  .
.  .......  ....  .  .......  ....  .  .......  .  ....  ....  .  .  .  ....  .  .  .  .  .
.     .  .                    .     .     .     .  .        .     .           .        .  .
.  .  .  .  .  ...................  .  ....  ..........  .  ....  ..........  .  ....  ....
.  .     .  .           .     .  .     .     .     .  .  .              .     .     .     .
.  ....  .  ....  ....  .  ....  ....  ....  .  ....  .......  ................  ..........
.  .        .        .  .              .        .     .  .  .           .  .        .     .
.  .  ................  ....  .......  .  .  .......  .  .  .  .  .......  .  .  .......  .
.  .  .     .     .        .  .  .     .  .  .  .     .     .  .     .  .     .  .        .
.......  ....  .  .  ..........  .  .......  .  .  .  ....  ..........  ..........  ....  .
.        .  .  .        .  .     .  .  .        .  .  .     .  .     .     .     .  .  .  .
....  .  .  .  .......  .  .  ....  .  .  ..........  .  .  .  .  .  .  ....  .  .  .  ....
.  .  .        .           .  .        .                 .        .  .  .  .  .  .        .
.  ..........  .............  .  .......  .  .  ...................  .  .  .  ....  .......
.     .                 .           .  .  .  .  .     .  .  .        .        .        .  .
.  ....  .......  .  .  ....  .......  ....  .  .  .  .  .  .  ....  ....  .  ....  ....  .
.     .  .  .     .  .              .  .     .     .  .  .  .  .        .  .     .  .     .
....  ....  .  .  .  .......  .......  ....  .  .  .  .  .  ....  .............  .  ....  .
.  .     .     .  .     .        .        .  .  .  .  .        .  .     .        .        .
.  ....  .  .......  ....  .  ....  .............  .......  .......  .......  .......  .  .
.        .  .     .  .  .  .              .  .                       .  .        .     .  .
.  ....  .  .  .......  .  ................  ..........  ....  ....  .  ....  ....  ....  .
.     .  .     .  .        .                 .  .        .        .  .  .           .     .
....  .......  .  ....  .  .  ....  ....  ....  .......  .  .  .  ....  .  .  ....  ....  .
.     .              .  .     .  .  .              .     .  .  .     .  .  .  .        .  .
.  ....  ......................  .  .............  .......  ..........  .............  ....
.  .     .  .  .              .        .              .  .  .  .  .           .     .  .  .
.  .  ....  .  ....  .  ....  ....  ....  ....  .......  .  .  .  .......  .  .  ....  .  .
.  .     .  .     .  .     .  .     .        .  .  .  .  .        .        .        .     .
.  .  ....  .  .......  .  ....  .  .......  .  .  .  .  .......  ....  .  .......  .  ....
.  .              .  .  .  .     .        .  .        .           .     .  .     .        .
.  .......  ....  .  .  ....  ....  ....  .............  ....  .......  .......  .  .......
.        .  .     .  .  .  .  .  .  .     .     .  .  .     .           .  .  .     .     .
.  .......  .  .  .  .  .  .  .  .............  .  .  .......  ....  .  .  .  .......  ....
.     .     .  .     .           .     .                 .        .  .  .        .  .     .
.  .  .  .......  .......  .  .......  ....  .  ....  .  ....  .  ....  .  ....  .  ....  .
.  .        .           .  .              .  .  .  .  .        .     .  .  .        .     .
.  ....  .........................  ....  .......  .  ....  .  .  .............  .......  .
.  .           .     .     .        .        .     .  .  .  .  .        .  .  .           .
.  ..........  .  ....  .......  .......  .  .  .  ....  .  .......  ....  .  ....  .  .  .
.        .           .           .        .     .  .              .  .  .           .  .  .
.  .  .  .  ..........  ..........  .  .  .  ..........  .......  ....  .  ....  .......  .
.  .  .  .     .  .  .     .        .  .  .  .     .  .     .  .              .  .        .
.  .  .  .  .  .  .  .............  .......  ....  .  .  .  .  .  .......  .............  .
.  .  .  .  .              .  .        .     .           .  .           .  .  .     .     .
.  .......  .............  .  ....  .  ....  ....  .  ...................  .  ....  ....  .
.     .     .  .  .        .  .     .  .           .     .     .  .  .  .  .              .
.  .  .  .  .  .  ..........  .  .  ....  ....  .......  .  ....  .  .  .  .  .  ....  .  .
.  .  .  .  .  .        .        .     .  .  .  .     .  .        .     .  .  .  .  .  .  .
.  .......  .  ....  ....  ....  .  .  ....  .......  .  ....  ....  ..........  .  .......
.     .  .  .     .  .  .  .  .  .  .           .              .  .     .     .  .        .
.......  .  .  .  .  .  ....  .  ..........  .......  .  .......  ....  .  .  ....  .......
.  .           .        .     .           .     .     .     .           .  .           .  .
.  .  ..........  .......  ....  ....  .  ....  .  .  .  .  ....  .  ....  ....  ....  .  .
.        .  .        .           .  .  .  .     .  .  .  .     .  .     .  .     .        .
.  .......  ....  .......  ....  .  ....  ..........  .......  ....  .......  ....  ....  .
.     .                 .  .     .           .           .                    .     .     
........................................................................................  
